{
  "keyboard": "gergo",
  "keymap": "gergo_layout",
  "layout": "LAYOUT_gergo",
  "layers": [
    [
      "KC_TAB",
      "KC_Q",
      "KC_W",
      "KC_E",
      "KC_R",
      "KC_T",
      "KC_Y",
      "KC_U",
      "KC_I",
      "KC_O",
      "KC_P",
      "KC_BSPC",
      "LGUI_T(KC_ESC)",
      "KC_A",
      "KC_S",
      "KC_D",
      "KC_F",
      "KC_G",
      "KC_VOLD",
      "KC_VOLU",
      "KC_H",
      "KC_J",
      "KC_K",
      "KC_L",
      "KC_SCLN",
      "KC_ENT",
      "KC_LSFT",
      "KC_Z",
      "KC_X",
      "KC_C",
      "KC_V",
      "KC_B",
      "KC_MPLY",
      "KC_MRWD",
      "KC_MFFD",
      "KC_NO",
      "KC_N",
      "KC_M",
      "KC_COMM",
      "KC_DOT",
      "KC_SLSH",
      "KC_RSFT",
      "KC_LALT",
      "KC_LCTL",
      "LT(1,KC_NO)",
      "LT(2,KC_NO)",
      "LT(2,KC_NO)",
      "LT(1,KC_QUOT)",
      "KC_SPC",
      "KC_RGUI"
    ],
    [
      "KC_GRV",
      "KC_EXLM",
      "KC_AT",
      "KC_HASH",
      "KC_DLR",
      "KC_PERC",
      "KC_CIRC",
      "KC_P7",
      "KC_P8",
      "KC_P9",
      "KC_BSLS",
      "KC_TRNS",
      "KC_TRNS",
      "KC_TRNS",
      "KC_TRNS",
      "KC_UP",
      "KC_TRNS",
      "KC_TRNS",
      "KC_TRNS",
      "KC_TRNS",
      "KC_MINS",
      "KC_P4",
      "KC_P5",
      "KC_P6",
      "KC_PLUS",
      "KC_TRNS",
      "KC_TRNS",
      "KC_TRNS",
      "KC_LEFT",
      "KC_DOWN",
      "KC_RGHT",
      "KC_TRNS",
      "KC_TRNS",
      "KC_TRNS",
      "KC_TRNS",
      "KC_TRNS",
      "KC_UNDS",
      "KC_P1",
      "KC_P2",
      "KC_P3",
      "KC_EQL",
      "KC_TRNS",
      "KC_TRNS",
      "KC_TRNS",
      "KC_TRNS",
      "KC_TRNS",
      "KC_TRNS",
      "KC_TRNS",
      "KC_P0",
      "KC_PDOT"
    ],
    [
      "KC_TRNS",
      "KC_TRNS",
      "KC_TRNS",
      "KC_TRNS",
      "KC_TRNS",
      "KC_TRNS",
      "KC_CIRC",
      "KC_AMPR",
      "KC_ASTR",
      "KC_LPRN",
      "KC_RPRN",
      "KC_TRNS",
      "KC_TRNS",
      "KC_TRNS",
      "KC_TRNS",
      "KC_TRNS",
      "KC_TRNS",
      "KC_TRNS",
      "KC_TRNS",
      "KC_TRNS",
      "KC_TRNS",
      "KC_TRNS",
      "KC_PLUS",
      "KC_LCBR",
      "KC_RCBR",
      "KC_TRNS",
      "KC_TRNS",
      "KC_TRNS",
      "KC_TRNS",
      "KC_TRNS",
      "KC_TRNS",
      "KC_TRNS",
      "KC_TRNS",
      "KC_TRNS",
      "KC_TRNS",
      "KC_TRNS",
      "KC_TRNS",
      "KC_TRNS",
      "KC_EQL",
      "KC_LBRC",
      "KC_RBRC",
      "KC_TRNS",
      "KC_TRNS",
      "KC_TRNS",
      "KC_TRNS",
      "KC_TRNS",
      "KC_TRNS",
      "KC_TRNS",
      "KC_TRNS",
      "KC_TRNS"
    ]
  ],
  "author": "",
  "notes": ""
}
